003,002
001,000
[]  [][][][][][][][][][][][][][][][][][][][][][][][][][][][][][][][][][][][][][][][][][][][][][][][]
[]      []              []      []                              []                          []      
[][][]  []  [][][]  [][][]  []  [][][]  []  [][][][][]  [][][]  []  [][][][][][][]  []  []  [][][]  
[]          []      []      []  []      []          []      []      []          []  []  []          
[]  [][][][][]  [][][]  []  []  []  [][][][][][][]  [][][]  [][][][][]  [][][]  []  []  []  [][][][]
[]          []          []  []  []  []      []      []      []          []      []  []  []          
[][][][][]  []  [][][][][]  []  []  []  []  []  [][][]  [][][]  [][][][][]  [][][]  []  [][][]  []  
[]  []      []  []          []  []  []  []  []      []          []  []      []      []      []  []  
[]  []  [][][]  []  [][][][][]  []  []  []  [][][]  []  [][][][][]  []  [][][]  [][][][][]  [][][]  
[]      []  []  []  []          []  []  []      []  []      []      []      []  []      []      []  
[]  [][][]  []  []  []  [][][][][]  []  [][][][][]  [][][]  []  [][][][][]  []  []  [][][][][]  []  
[]  []  []      []  []          []  []              []      []              []      []          []  
[]  []  []  [][][]  [][][][][]  []  [][][][][][][][][]  [][][][][][][][][][][][][][][]  []  []  []  
[]      []      []          []  []      []          []  []          []                  []  []  []  
[]  [][][][][]  [][][][][]  []  [][][]  []  [][][]  [][][]  []  []  []  []  [][][][][][][]  [][][]  
[]          []  []      []  []  []      []      []      []  []  []      []  []          []  []      
[]  [][][]  []  [][][]  []  []  []  [][][][][]  [][][]  []  [][][][][][][]  []  [][][]  []  []  [][]
[]      []  []          []  []  []      []  []      []  []      []      []  []      []  []  []      
[][][]  []  [][][][][][][]  []  []  []  []  [][][]  []  [][][]  []  []  []  [][][]  []  []  []  []  
[]  []  []          []      []  []  []  []          []          []  []  []  []      []  []  []  []  
[]  []  [][][][][]  []  [][][]  []  []  []  [][][][][][][][][][][]  [][][]  []  []  [][][]  []  []  
[]      []      []  []      []  []  []  []  []                  []          []  []  []      []  []  
[][][][][]  []  []  []  []  []  [][][]  []  []  []  [][][][][]  [][][][][][][]  []  []  []  []  []  
[]          []      []  []  []          []      []  []          []      []      []  []  []  []  []  
[]  [][][][][][][][][][][]  [][][][][][][][][][][]  []  [][][][][]  []  []  [][][][][]  []  []  []  
[]          []              []      []          []  []              []  []      []      []  []  []  
[][][][][]  []  [][][][][][][]  []  []  [][][]  []  [][][][][][][][][]  []  []  []  [][][][][]  []  
[]      []  []  []      []      []  []  []      []              []      []  []      []  []      []  
[]  []  []  []  []  []  []  [][][]  []  []  []  [][][][][][][][][]  [][][][][][][][][]  []  []  []  
[]  []  []  []      []  []  []      []  []  []      []              []                  []  []  []  
[]  []  []  [][][][][]  []  []  [][][][][]  [][][]  []  [][][][][][][]  []  [][][][][][][]  [][][]  
[]  []  []          []  []  []          []      []  []                  []  []  []          []      
[]  [][][][][]  []  []  []  [][][]  []  [][][]  []  [][][][][][][]  [][][]  []  []  [][][][][]  []  
[]  []      []  []  []  []      []  []          []  []          []      []      []  []      []  []  
[]  []  []  [][][]  []  [][][]  []  [][][][][][][]  []  []  []  [][][]  [][][][][]  []  []  []  []  
[]      []      []  []          []              []      []  []  []      []      []  []  []      []  
[]  [][][][][]  []  []  [][][][][][][][][][][][][][][][][][][]  [][][][][]  []  []  []  [][][][][]  
[]          []      []          []              []  []      []  []      []  []      []  []          
[][][][][]  []  [][][][][][][]  []  [][][]  []  []  []  []  []  []  []  []  [][][][][]  [][][][][][]
[]  []      []          []      []      []  []  []      []  []  []  []  []  []      []              
[]  []  [][][][][][][]  []  [][][][][]  [][][]  []  [][][]  []  []  []  []  []  [][][][][]  [][][]  
[]      []      []  []  []          []      []  []  []      []  []  []      []  []      []      []  
[][][][][][][]  []  []  []  [][][]  [][][]  []  [][][]  [][][]  []  []  [][][]  []  []  []  []  []  
[]          []  []      []  []  []  []      []      []      []  []  []  []      []  []  []  []  []  
[]  [][][]  []  []  [][][]  []  []  []  [][][][][]  [][][]  []  []  [][][]  [][][]  []  [][][]  []  
[]  []      []  []      []      []  []      []      []      []  []      []      []  []      []  []  
[][][]  []  []  [][][][][][][][][]  []  []  []  [][][]  [][][]  []  []  [][][]  []  [][][]  [][][]  
[]      []  []                      []  []  []      []          []  []          []      []      []  
[]  [][][][][][][][][][][][][][][][][][][]  []  []  [][][][][][][][][][][][][][][][][]  []  []  []  
[]                                          []  []                                      []  []      
