001,001
001,000
[]  [][][][][][][][][][][][][][][][][][][][][][][][][][][][][][][][][][][][][][][][][][][][][][][][]
[]  []      []                  []                  []                  []                          
[]  []  [][][]  []  []  [][][][][]  [][][]  [][][]  [][][]  []  [][][]  []  []  [][][][][]  [][][]  
[]              []  []          []      []      []      []  []      []      []          []      []  
[]  [][][][][][][]  [][][]  []  [][][]  [][][]  [][][]  []  [][][]  [][][][][][][][][]  [][][]  []  
[]  []          []      []  []      []  []      []      []  []      []          []      []      []  
[][][]  [][][][][][][]  []  [][][]  []  []  [][][]  [][][]  []  [][][][][][][]  []  []  []  [][][]  
[]      []              []      []      []  []      []      []              []      []  []  []  []  
[]  [][][]  []  [][][][][][][]  []  [][][]  []  [][][]  [][][][][][][][][]  [][][][][]  []  []  []  
[]          []  []      []      []      []  []          []          []      []          []      []  
[][][][][]  []  []  [][][]  [][][][][]  []  [][][][][]  [][][][][]  []  [][][]  [][][][][]  [][][]  
[]      []  []  []      []      []  []  []          []  []          []      []  []      []      []  
[]  []  []  []  [][][]  [][][]  []  []  []  [][][]  [][][]  []  [][][][][]  []  []  []  [][][][][]  
[]  []  []  []      []      []  []      []      []      []  []  []      []  []  []  []  []      []  
[]  []  [][][][][]  []  []  []  [][][]  [][][]  []  []  []  [][][]  []  []  [][][]  [][][]  []  []  
[]  []      []      []  []  []      []  []      []  []      []      []  []          []      []  []  
[]  [][][]  []  []  []  []  [][][]  []  []  [][][][][][][][][]  []  []  [][][][][][][]  [][][]  []  
[]      []  []  []  []  []  []      []  []  []      []          []  []          []      []      []  
[][][]  []  []  []  []  []  []  [][][][][]  []  []  []  []  [][][]  []  [][][]  []  [][][]  []  []  
[]      []      []  []  []      []          []  []      []      []  []  []      []  []      []  []  
[]  [][][][][][][]  []  [][][][][]  [][][]  []  [][][][][][][][][]  [][][]  [][][]  []  [][][]  []  
[]  []      []  []  []          []      []  []  []  []              []      []  []  []      []  []  
[]  [][][]  []  []  []  [][][]  []  []  [][][]  []  []  [][][][][]  []  [][][]  []  [][][]  [][][]  
[]          []  []  []  []      []  []          []      []      []  []  []      []      []          
[]  [][][][][]  []  [][][]  []  []  [][][][][][][][][][][]  []  [][][]  []  [][][][][]  [][][][][][]
[]          []      []      []  []                      []  []      []      []      []  []      []  
[][][][][]  [][][][][]  [][][]  [][][][][][][]  [][][]  []  []  []  []  [][][]  []  []  []  []  []  
[]      []          []      []      []      []      []  []  []  []  []  []      []  []      []      
[][][]  []  [][][]  []  []  [][][]  []  []  [][][]  []  []  [][][]  []  []  [][][]  [][][][][][][][]
[]      []  []      []  []  []      []  []  []      []      []      []  []  []  []          []      
[]  [][][]  []  []  [][][]  []  [][][]  []  [][][][][]  [][][]  [][][][][]  []  [][][][][]  []  []  
[]  []      []  []  []      []  []      []          []      []              []      []      []  []  
[]  []  [][][]  [][][]  [][][]  []  []  [][][][][]  []  [][][][][][][]  [][][][][]  []  [][][]  []  
[]  []      []  []      []      []  []          []  []  []          []      []      []          []  
[]  [][][][][]  []  [][][]  [][][]  []  []  []  []  [][][]  []  []  []  [][][]  []  [][][][][]  []  
[]      []      []      []          []  []  []  []          []  []  []  []      []  []      []  []  
[]  []  []  [][][][][]  [][][][][][][]  []  []  []  [][][][][]  []  [][][]  [][][]  [][][]  []  []  
[]  []  []  []      []      []          []  []  []          []  []      []      []      []  []  []  
[][][]  []  []  []  [][][]  [][][][][]  [][][]  [][][][][]  []  [][][]  [][][]  []  []  []  []  []  
[]      []  []  []      []  []      []  []      []          []  []      []      []  []      []  []  
[]  [][][]  []  []  []  []  []  []  [][][]  [][][]  [][][][][]  []  [][][]  [][][]  [][][][][]  []  
[]      []  []  []  []  []      []      []      []  []      []  []          []  []          []  []  
[][][]  []  []  [][][]  []  [][][][][]  [][][]  []  []  []  []  [][][][][][][]  []  [][][]  []  []  
[]      []  []  []      []          []      []  []  []  []  []  []          []  []  []      []  []  
[]  []  []  []  []  [][][][][][][]  [][][]  []  [][][]  []  []  []  [][][]  []  [][][]  [][][]  []  
[]  []  []  []  []  []      []  []  []      []      []  []      []  []      []          []      []  
[]  []  []  []  [][][]  []  []  []  []  [][][][][]  []  [][][][][]  []  [][][][][][][][][]  [][][]  
[]  []  []  []      []  []  []      []  []      []  []      []      []  []                  []      
[]  [][][]  []  []  []  []  [][][][][]  []  [][][]  [][][]  []  [][][]  [][][][][][][][][][][]  []  
[]          []  []      []              []          []      []      []                              
