002,001
001,000
[]  [][][][][][][][][][][][][][][][][][][][][][][][][][][][][][][][][][][][][][][][][][][][][][][][]
[]              []          []                              []                                      
[][][]  [][][]  []  []  []  []  [][][][][]  [][][][][]  [][][]  [][][]  []  [][][][][][][]  [][][]  
[]          []      []  []  []  []      []  []          []      []      []              []  []      
[]  [][][]  [][][][][]  []  []  [][][]  []  []  [][][][][]  [][][]  [][][][][][][][][]  [][][]  []  
[]      []      []      []  []      []  []  []              []      []          []      []      []  
[]  []  [][][]  [][][][][]  [][][]  []  []  [][][][][][][][][]  []  [][][][][]  []  [][][]  [][][][]
[]  []      []      []      []      []  []      []          []  []  []      []  []  []      []      
[]  [][][]  [][][]  []  [][][]  [][][]  []  []  []  [][][][][]  []  []  []  []  []  []  [][][][][]  
[]  []      []      []  []      []      []  []      []  []      []  []  []      []  []              
[][][]  [][][]  []  []  []  []  []  []  []  [][][][][]  []  [][][][][]  [][][][][]  [][][][][][][][]
[]      []      []  []      []  []  []  []          []  []  []      []  []      []      []          
[]  [][][]  [][][][][][][]  [][][]  []  [][][][][]  []  []  []  []  []  []  []  []  []  []  []  []  
[]      []              []  []      []          []      []  []  []      []  []  []  []      []  []  
[]  []  [][][][][][][]  []  []  [][][][][][][]  [][][][][]  []  [][][][][]  []  [][][]  [][][][][]  
[]  []              []  []  []          []  []      []      []      []      []      []  []      []  
[]  []  [][][][][][][]  []  [][][][][]  []  []  []  []  [][][][][]  []  []  [][][]  [][][]  []  []  
[]  []          []      []      []      []  []  []  []              []  []      []      []  []  []  
[]  [][][][][][][]  [][][][][][][]  []  []  [][][]  [][][][][][][][][]  []  []  [][][]  []  []  []  
[]      []          []              []  []      []                      []  []  []      []  []  []  
[][][]  []  [][][]  []  [][][]  [][][]  [][][]  [][][][][]  [][][][][][][]  []  []  [][][]  []  []  
[]      []      []  []      []  []  []  []      []      []              []  []  []          []  []  
[]  [][][][][]  [][][][][]  []  []  []  []  [][][]  []  [][][]  [][][]  []  []  [][][][][][][]  []  
[]          []      []      []      []  []      []  []      []  []      []  []  []  []      []  []  
[]  [][][]  []  []  []  [][][][][][][]  [][][]  [][][]  []  []  []  [][][]  []  []  []  [][][]  []  
[]  []      []  []  []  []          []      []      []  []  []  []      []  []  []  []      []  []  
[][][]  [][][][][]  []  []  []  []  []  []  [][][]  []  []  [][][][][]  []  []  []  []  []  []  []  
[]      []      []      []  []  []  []  []      []  []  []      []      []  []      []  []      []  
[]  [][][]  []  [][][][][]  []  []  [][][][][][][]  []  [][][]  [][][][][]  [][][][][][][][][][][]  
[]          []  []          []  []              []  []      []              []              []      
[]  [][][][][]  []  [][][][][]  [][][][][]  []  []  [][][]  [][][][][][][][][]  [][][][][]  []  []  
[]      []      []  []          []      []  []      []  []  []              []  []      []      []  
[]  [][][]  [][][]  []  [][][][][][][]  []  [][][]  []  []  []  [][][][][]  []  []  []  [][][][][]  
[]  []      []      []  []              []      []  []  []  []          []      []  []          []  
[]  []  [][][]  []  []  []  [][][][][][][][][]  [][][]  []  [][][][][]  [][][][][]  []  [][][]  [][]
[]  []          []  []  []          []      []          []          []              []      []      
[]  [][][]  [][][]  []  []  [][][]  []  []  []  [][][][][][][]  []  [][][][][][][][][][][]  []  []  
[]      []      []  []  []      []      []  []              []  []  []      []          []  []  []  
[]  []  [][][]  []  []  [][][][][][][][][]  [][][][][][][]  []  []  []  []  []  [][][]  []  [][][]  
[]  []      []  []  []      []          []          []      []  []      []      []      []  []      
[]  []  []  [][][]  [][][]  []  [][][]  [][][][][]  []  [][][][][][][][][][][][][]  [][][][][]  [][]
[]  []  []      []      []      []  []          []  []          []      []      []      []      []  
[]  [][][][][]  [][][]  [][][][][]  []  [][][]  []  []  []  []  []  []  []  []  [][][]  []  [][][]  
[]      []      []      []          []  []      []  []  []  []      []  []  []      []  []          
[][][]  []  [][][][][][][]  []  [][][][][]  []  []  []  [][][][][][][]  []  [][][]  []  [][][][][][]
[]  []  []  []          []  []      []      []  []  []      []  []      []  []      []  []          
[]  []  []  []  []  []  []  [][][][][]  [][][][][]  []  []  []  []  [][][]  [][][]  []  []  []  []  
[]  []  []  []  []  []  []          []          []  []  []  []  []      []      []  []      []  []  
[]  []  []  []  []  []  [][][][][]  []  [][][]  []  []  []  []  []  []  [][][]  [][][][][][][][][]  
[]      []      []  []              []      []      []  []      []  []      []                      
