002,001
002,000
[]  [][][][][][][][][][][][][][][][][][]
[]      []                              
[][][]  []  []  [][][][][][][]  []  []  
[]      []  []              []  []  []  
[]  []  []  [][][][][][][]  []  [][][]  
[]  []      []  []          []  []      
[]  [][][][][]  []  []  [][][][][]  [][]
[]  []          []  []  []      []  []  
[][][]  []  [][][]  []  []  []  []  []  
[]      []      []  []  []  []      []  
[]  []  [][][]  []  [][][]  [][][][][]  
[]  []  []      []      []              
[]  [][][]  [][][][][]  [][][]  [][][][]
[]  []      []      []      []      []  
[]  []  [][][]  []  [][][]  []  []  []  
[]  []          []      []  []  []      
[]  []  [][][][][][][][][]  []  [][][][]
[]  []              []      []          
[]  [][][][][][][][][]  [][][][][][][]  
[]                      []              
