002,001
020,013
[]  [][][][][][][][][][][][][][][][][][][][][][][][][][][][]
[]          []          []                                  
[][][]  []  []  []  []  []  []  [][][][][]  [][][]  [][][][]
[]      []      []  []      []      []  []      []  []      
[]  [][][][][][][][][][][][][][][]  []  []  []  [][][]  []  
[]  []      []                  []  []  []  []          []  
[]  []  []  []  []  [][][][][]  []  []  []  [][][][][][][]  
[]      []  []  []      []      []      []              []  
[]  [][][]  []  [][][][][]  [][][][][][][][][][][][][][][]  
[]      []      []      []      []                          
[]  []  [][][]  []  []  [][][]  []  [][][][][][][][][][][][]
[]  []      []  []  []          []  []          []          
[][][][][]  [][][]  [][][][][][][]  []  [][][]  []  []  []  
[]          []      []      []      []      []      []  []  
[]  [][][][][]  [][][]  []  []  [][][][][]  []  [][][][][]  
[]          []      []  []  []              []      []      
[]  [][][]  [][][]  []  []  [][][][][][][][][][][]  []  [][]
[]      []      []      []          []      []      []  []  
[][][]  [][][]  []  [][][][][]  []  [][][]  []  [][][]  []  
[]      []  []  []          []  []  []      []      []      
[]  [][][]  []  [][][][][]  []  []  []  [][][][][]  [][][][]
[]          []      []      []  []  []              []      
[]  [][][][][][][]  []  [][][][][]  [][][][][][][][][]  []  
[]          []      []      []      []      []          []  
[][][][][]  []  [][][][][][][]  [][][]  []  []  [][][][][]  
[]  []      []  []      []      []      []  []  []  []      
[]  []  [][][]  []  []  []  [][][]  [][][]  []  []  []  [][]
[]  []      []  []  []  []          []  []      []  []      
[]  [][][]  []  []  []  [][][][][][][]  []  [][][]  [][][]  
[]          []      []                  []      []          
