000,003
025,013
[]  [][][][][][][][][][][][][][][][][][][][][][][][][][][][]
[]  []                                  []          []      
[]  []  []  [][][][][][][]  [][][][][]  [][][]  []  []  []  
[]      []      []          []      []  []      []      []  
[][][][][][][]  []  [][][][][]  []  []  []  []  [][][][][]  
[]          []  []  []          []  []  []  []  []      []  
[]  [][][]  []  []  []  []  [][][]  []  []  []  []  [][][]  
[]  []      []  []      []      []  []      []  []          
[]  [][][][][]  []  []  [][][]  []  []  [][][][][][][][][][]
[]              []  []  []      []  []      []              
[][][][][][][]  []  [][][]  [][][]  [][][][][]  []  [][][]  
[]          []  []      []  []  []  []          []      []  
[][][][][]  [][][][][]  []  []  []  []  []  [][][][][]  []  
[]      []              []  []  []      []  []  []      []  
[]  []  [][][][][][][][][]  []  []  [][][]  []  []  [][][]  
[]  []          []      []      []  []  []      []      []  
[]  [][][][][]  []  []  [][][][][]  []  []  [][][][][][][]  
[]          []  []  []          []      []      []          
[][][][][]  []  []  [][][][][]  [][][][][][][]  []  [][][][]
[]          []  []          []          []      []          
[]  [][][][][][][][][]  []  [][][][][]  []  [][][]  [][][]  
[]  []              []  []          []  []      []      []  
[]  []  [][][][][]  []  [][][][][]  []  [][][]  [][][]  []  
[]  []          []  []      []  []  []      []      []  []  
[]  []  [][][]  []  []  []  []  []  [][][]  [][][]  []  []  
[]  []  []      []  []  []      []  []      []  []  []  []  
[]  []  []  [][][]  []  [][][][][]  []  [][][]  []  [][][]  
[]  []  []  []      []      []      []      []      []      
[]  [][][]  []  [][][][][][][]  []  [][][]  [][][][][]  []  
[]          []                  []      []                  
