002,002
011,020
[]  [][][][][][][][][][][][][][][][][][][][][][][][][][][][]
[]                                                          
[][][][][][][][][]  []  [][][][][]  [][][]  []  []  [][][]  
[]              []  []  []      []      []  []  []  []      
[]  []  [][][]  []  []  [][][]  []  []  [][][]  []  []  [][]
[]  []  []      []  []  []      []  []  []      []  []      
[][][]  []  [][][]  []  []  [][][]  []  []  [][][]  [][][]  
[]      []  []      []      []      []  []      []      []  
[]  [][][]  [][][][][]  [][][]  [][][]  [][][]  [][][][][]  
[]      []          []      []      []      []          []  
[]  []  [][][][][]  [][][]  [][][]  [][][]  [][][][][]  [][]
[]  []      []      []      []  []  []      []      []      
[]  [][][]  []  [][][]  [][][]  []  []  [][][]  []  [][][]  
[]      []  []      []          []  []  []      []  []      
[][][]  []  [][][]  []  [][][][][]  []  []  [][][]  []  [][]
[]      []      []  []          []  []  []  []  []  []      
[][][][][]  [][][]  [][][][][]  []  []  []  []  []  []  []  
[]      []  []      []          []  []  []  []      []  []  
[]  []  [][][]  []  []  [][][][][]  []  []  [][][][][][][]  
[]  []      []  []  []  []          []  []          []      
[]  []  []  []  []  []  []  [][][][][]  []  [][][]  []  [][]
[]  []  []      []  []  []  []          []  []      []      
[]  [][][][][][][]  []  []  []  [][][][][][][]  []  [][][]  
[]          []      []  []  []                  []  []      
[]  [][][]  [][][]  []  []  [][][][][][][][][][][]  []  [][]
[]      []      []  []  []                      []  []      
[]  []  [][][]  []  []  [][][][][][][][][][][]  []  [][][]  
[]  []  []  []  []  []      []          []      []      []  
[]  []  []  []  [][][][][][][]  []  []  [][][][][][][][][]  
[]  []      []                  []  []                      
