############################################
############################################
############################################
############################################
#####                  ##              #####
#########  ##############  ##########  #####
#########  ##############  ##########  #####
#####      ##          ##      ##      #####
#####  ##  ##  ######  ######  ##  #########
#####  ##  ##  ######  ######  ##  #########
#####  ##  ##  ##  ##      ##  ##      #####
#####  ######  ##  ######  ##  ######  #####
#####  ######  ##  ######  ##  ######  #####
#####      ##          ##          ##  #####
#####  ##  ######  ##################  #####
#####  ##  ######  ##################  #####
#####  ##          ##          ##      #####
#####  ######################  ##  ##  #####
#####  ######################  ##  ##  #####
#####      ##      ##          ##  ##  #####
#########  ##  ##  ##  ##########  ##  #####
#########  ##  ##  ##  ##########  ##  #####
#####  ##      ##  ##  ##          ##  #####
#####  ##  ##########  ##  ##  ######  #####
#####  ##  ##########  ##  ##  ######  #####
#####  ##  ##          ##  ##      ##  #####
#####  ##  ##  ##################  ##  #####
#####  ##  ##  ##################  ##  #####
#####      ##                      ##  #####
############################################
############################################
############################################
############################################