014,001
02,022
[]  [][][][][][][][][][][][][][][][][][][][][][][][][][][][]
[]                  []                                      
[][][]  [][][][][]  []  []  [][][][][]  [][][][][]  []  []  
[]              []  []  []          []          []  []  []  
[]  [][][][][][][]  []  [][][][][][][][][]  []  [][][]  [][]
[]          []      []                  []  []      []      
[]  []  []  []  [][][]  [][][][][]  []  []  [][][]  [][][]  
[]  []  []  []      []  []      []  []  []  []  []      []  
[]  [][][]  []  []  [][][]  []  [][][]  []  []  [][][]  []  
[]  []      []  []      []  []          []  []      []  []  
[]  []  [][][]  []  []  []  [][][][][]  []  [][][]  []  [][]
[]  []  []      []  []      []      []  []          []      
[][][]  [][][][][]  [][][][][]  []  [][][]  [][][][][][][]  
[]      []      []  []          []      []          []      
[]  [][][]  []  [][][]  [][][]  [][][]  [][][][][][][]  [][]
[]  []      []      []      []  []  []              []      
[]  []  []  [][][]  [][][]  []  []  []  []  [][][]  [][][]  
[]      []      []          []      []  []      []      []  
[][][][][]  []  [][][][][][][][][][][]  [][][][][][][][][]  
[]      []  []          []  []          []              []  
[]  []  [][][][][][][]  []  []  [][][][][]  [][][][][]  []  
[]  []              []  []      []      []      []      []  
[]  []  [][][][][]  []  [][][][][]  []  [][][]  []  []  []  
[]  []          []  []          []  []      []  []  []  []  
[]  []  [][][]  []  [][][][][]  []  [][][]  []  []  [][][]  
[]  []  []      []          []  []  []  []  []  []      []  
[]  []  []  [][][][][][][][][]  []  []  []  []  []  []  []  
[]  []  []          []      []  []      []  []  []  []      
[]  [][][][][][][][][]  []  []  []  [][][]  []  []  [][][][]
[]                      []      []      []      []          
